WWWWWWWWWWWWWWWWWWWW
W..................W
W..WWWW............W
W......W...........W
W......W...........W
W......WWWW........W
W..................W
W...........WWWWW..W
W...........W......W
W...P.......W......W
W...........W......W
W...........WWWWW..W
W..................W
W..WWWWWWWW........W
W..................W
W..................W
WWWWWWWWWWWWWWWWWWWW
